444444444
400000004
411111104
401000104
401030104
401000104
401101104
400000004
444444444
