444444444
400000004
411111104
400010104
403010104
400010004
410110114
400000004
444444444
