444444444
400000104
410110104
400010004
403011104
400010004
411110114
400000004
444444444
