444444444444444444444
400010000000000000004
411011111110101111104
401000100010100010004
401110101010111010114
400010001010001010104
401011111010111010104
401000100010100010104
401110101111101110104
401010001000100010004
401011111010111011104
401000000010000010004
401010101111111110114
401010101000100010104
401010100030101110104
401010001000100010104
401011101111111010104
401000100010000010104
401111111010111110104
400000000010000000004
444444444444444444444
