4444444444444
4010001000004
4011101010104
4000100010104
4110110110104
4000100010104
4011103010104
4000100010104
4110111110104
4010100010104
4010101010104
4000001000104
4444444444444
