444444444444444444444
401000000010000000004
401010111011101111114
401010101000100000004
401110101110101111104
400000101000100000104
411111101011111110104
400000001010100010104
401111101010003011104
400010001010100010004
411110101010111110104
400000101000001000104
401111101111101011104
401000000000101000104
401011111110101110104
401010001000100000104
401010101111111111104
401010100000100000104
401110111110101011104
400000000010001000004
444444444444444444444
