444444444
401000104
401030004
401000104
401111104
401000004
401111104
400000004
444444444
