44444444444444444
40100000000000004
40101111111111104
40001010000000104
41111010111110104
40000010001010004
40111111101011114
40100000001000004
40101111111111104
40101000000000104
40101111101110104
40001000101000004
40111030001111104
40101000100000104
40101111111110104
40000000000000104
44444444444444444
