444444444
401000104
401030004
401000104
401111104
401000004
401011104
400010004
444444444
