444444444444444444444
401000001000101000004
401111100030101010114
400010001000101010004
411010101111101011104
401010101010000010004
401010101010111110114
401000101000100010004
401111101111101011104
400000100000001000104
411010111111111110104
400010000000000010104
401111111110111110104
400000000010100000104
401111111011101111104
400010001000001000004
411010111111111011104
401010000010001010004
401011101010101010114
400000001000100010004
444444444444444444444
