4444444444444
4010000000104
4010110110104
4010100010104
4010103010104
4000100010004
4111111111104
4000000010004
4010111110114
4010100010104
4010101010104
4010001000004
4444444444444
