444444444444444444444
401000001000000000004
401110101011111011104
400010100010001010004
411011111110101110104
400010000000100000104
401110111111111111104
400000100000001000104
411111101111101110104
400000001000100000104
411011101010111111104
400010001010000000104
401111111011111110104
400000000010100010004
401111111110103000114
401000000000100010004
401111101110111110104
400000001010100000104
411111111010111110104
400000000000000000104
444444444444444444444
