444444444444444444444
401000001000000000004
401010101111101111104
401010101000001000004
401110101011111110114
401000101000100010004
401011101110103011104
401000100010100010104
401110111010110110104
400000101000100010004
411111101111101010114
400010000000001010104
401011111111101010104
401000000000001010004
401111111111111111104
401000000010000000104
401011111010111110104
401010001010100010104
401011101010111010104
400000001000000010004
444444444444444444444
