444444444
400000004
410111104
400010104
403010104
400010004
411110114
400000004
444444444
