444444444444444444444
401000100000100000104
401010101011101010104
400010101000001010004
411110111111101011104
400010000000101000104
411011111110101110114
400000000010100010004
401111111010101111104
400000100010101000004
401110110110111011104
400010100010000010004
411110103011111110114
400000100010000010004
401111111110101111104
401000000010101000004
401011111010101011114
401010001000101000004
401010101111101111104
400000100000100000004
444444444444444444444
