444444444
401000104
400030104
401000104
401111104
400010004
411011104
400000004
444444444
