4444444444444
4000001000004
4111101110104
4000100000104
4030001111104
4000100000104
4111101011104
4000101000104
4011101110104
4000001010104
4011111010104
4000000010004
4444444444444
