444444444444444444444
401000000000001000004
401111111011101110114
400010000010000010004
411010101111111011104
401010101000101000004
401010111010101111104
401010000010100000104
401011011010101011104
400010001010101010004
401110301010111010114
400010001010001000104
411011111011101011104
401000100010001010004
401110111010111010104
400010001010100010104
401011101110101110104
401010001000100000104
401110111011111111104
400000000010000000004
444444444444444444444
