444444444444444444444
400010000000000000004
411011101111111111104
401000100000100010004
401110111110101010114
400010100010001010004
411010003010111011104
400010100010001000104
401110111111111110104
400000100000000000104
401111111110111111104
400000000000100010004
411111111111111010114
400000001000000010104
401111101010111110104
400010001010100000104
401011111010101111104
401000000010001000004
401111111111111111104
400000000000000000004
444444444444444444444
