444444444444444444444
400010000000000000004
411010111111101111104
401010100010001000104
401010111010101010104
401010000010101010104
401011111010101010104
401010000010101010104
401011111010111010114
401000001010001010004
401111101011101011104
400000101000100000104
411110101110110111104
400000100010100010004
401111111011103010104
401000001000100010104
401011101110111110114
400010000010000010004
401110111111111011104
400010000000000000004
444444444444444444444
