444444444444444444444
400010000000000000004
411011111011111111104
401000000010000010004
401111111110101010114
400000000000101010104
401111111111101110104
401000101000001000104
401030001011101011104
401000101010001000104
401111101010111110104
400000001010001010004
411111101011101011104
400010001010000000104
401011111011111111104
401000000010000000004
401111111110111111114
401000000010001000004
401011111011101011104
400000001000000010004
444444444444444444444
