4444444444444
4000100000004
4110110110104
4010100010104
4010103010104
4010100010104
4010111111104
4000100000104
4011101110104
4010001000104
4010111011104
4000100000004
4444444444444
