444444444
401000104
400030104
401000104
401111104
401000004
401110104
400000104
444444444
