4444444444444
4010000000004
4010111110114
4010100010004
4011101010104
4000001010104
4101111011104
4000101010004
4030101010104
4000100010104
4111101110104
4000000000104
4444444444444
